64
0:0:0:0:0:0:0:0:0:0:0:0:0:0:0:0:0:0:0:0:0:0:0:0:0:0:0:0:0:0:0:0:0:0:0:0:0:0:0:0:0:0:0:0:0:0:0:0:0:0:0:0:0:0:0:0:0:0:0:0:0:0:0:0
0:0:0:0:0:0:0:0:0:0:0:0:0:0:0:0:0:0:0:0:0:0:0:0:0:0:0:0:0:0:0:0:0:0:0:0:0:0:0:0:0:0:0:0:0:0:0:0:0:0:0:0:0:0:0:0:0:0:0:0:0:0:0:0
0:0:0:0:0:0:0:0:0:0:0:0:0:0:0:0:0:0:0:0:0:0:0:0:0:0:0:0:0:0:0:0:0:0:0:0:0:0:0:0:0:0:0:0:0:0:0:0:0:0:0:0:0:0:0:0:0:0:0:0:0:0:0:0
0:0:0:0:0:0:0:0:0:0:0:0:0:0:0:0:0:0:0:0:0:0:0:0:0:0:0:0:0:0:0:0:0:0:0:0:0:0:0:0:0:0:0:0:0:0:0:0:0:0:0:0:0:0:0:0:0:0:0:0:0:0:0:0
0:0:0:0:0:0:0:0:0:0:0:0:0:0:0:0:0:0:0:0:0:0:0:0:0:0:0:0:0:0:0:0:0:0:0:0:0:0:0:0:0:0:0:0:0:0:0:0:0:0:0:0:0:0:0:0:0:0:0:0:0:0:0:0
0:0:0:0:0:0:0:0:0:0:0:0:0:0:0:0:0:0:0:0:0:0:0:0:0:0:0:0:0:0:0:0:0:0:0:0:0:0:0:0:0:0:0:0:0:0:0:0:0:0:0:0:0:0:0:0:0:0:0:0:0:0:0:0
0:0:1:4:6:10:11:10:10:11:10:10:11:10:10:11:10:10:6:0:0:0:4:10:10:11:10:10:11:11:10:10:11:10:10:11:10:10:11:10:10:11:10:10:11:10:10:11:10:10:11:10:10:11:10:10:11:10:8:2:0:0:0:0
0:0:0:1:4:6:10:9:10:11:10:9:10:10:10:9:10:10:5:0:0:0:6:10:10:10:10:11:10:10:9:10:10:10:9:10:10:10:9:10:10:10:9:10:10:10:9:10:10:10:11:10:10:11:10:10:11:10:7:3:0:0:0:0
0:0:0:0:4:7:8:10:8:7:6:10:11:10:10:10:11:10:4:0:0:0:5:11:10:10:10:11:11:10:10:11:10:10:10:11:10:10:10:11:10:10:10:11:10:10:10:11:10:10:11:10:10:11:10:10:11:10:7:5:0:0:0:0
0:0:0:0:4:7:8:10:8:7:6:0:0:0:0:0:0:0:0:0:0:0:0:0:0:0:0:0:0:0:0:0:0:0:0:0:0:0:0:0:0:0:0:0:0:0:0:0:0:0:0:0:0:6:8:10:10:11:8:6:0:0:0:0
0:0:0:0:4:7:8:10:8:7:6:0:0:0:0:0:0:0:0:0:0:0:0:0:0:0:0:0:0:0:0:0:0:0:0:0:0:0:0:0:0:0:0:0:0:0:0:0:0:0:0:0:0:6:8:10:10:11:8:6:0:0:0:0
0:0:0:0:4:7:8:10:8:7:6:0:0:0:0:0:0:0:0:0:0:0:0:0:0:0:0:0:0:0:0:0:0:0:0:0:0:0:0:0:0:0:0:0:0:0:0:0:0:0:0:0:0:6:8:10:10:11:8:6:0:0:0:0
0:0:0:0:4:7:8:10:8:7:6:0:0:0:0:0:0:0:0:0:0:0:0:0:0:0:0:0:0:0:0:0:0:0:0:0:0:0:0:0:0:0:0:0:0:0:0:0:0:0:0:0:0:6:8:10:10:11:8:6:0:0:0:0
0:0:0:0:4:7:8:10:8:7:6:0:0:0:0:0:0:0:0:0:0:0:0:0:0:0:0:0:0:0:0:0:0:0:0:0:0:0:0:0:0:0:0:0:0:0:0:0:0:0:0:0:0:6:8:10:10:11:8:6:0:0:0:0
0:0:0:0:4:7:8:10:8:7:6:0:0:0:0:0:0:0:0:0:0:0:0:0:0:0:0:0:0:0:0:0:0:0:0:0:0:0:0:0:0:0:0:0:0:0:0:0:0:0:0:0:0:6:8:10:10:11:8:6:0:0:0:0
0:0:0:0:4:7:8:10:8:7:6:0:0:0:0:0:0:0:0:0:0:0:0:0:0:0:0:0:0:0:0:0:0:0:0:0:0:0:0:0:0:0:0:0:0:0:0:0:0:0:0:0:0:6:8:10:10:11:8:6:0:0:0:0
0:0:0:0:4:7:8:10:8:7:6:0:0:0:0:0:0:0:0:0:0:0:0:0:0:0:0:0:0:0:0:0:0:0:0:0:0:0:0:0:0:0:0:0:0:0:0:0:0:0:0:0:0:6:8:10:10:11:8:6:0:0:0:0
0:0:0:0:4:7:8:10:8:7:6:0:0:0:0:0:0:0:0:0:0:0:0:0:0:0:0:0:0:0:0:0:0:0:0:0:0:0:0:0:0:0:0:0:0:0:0:0:0:0:0:0:0:6:8:10:10:11:8:6:0:0:0:0
0:0:0:0:4:7:8:10:8:7:6:0:0:0:0:0:0:0:0:0:0:0:0:0:0:0:0:0:0:0:0:0:0:0:0:0:0:0:0:0:0:0:0:0:0:0:0:0:0:0:0:0:0:6:8:10:10:11:8:6:0:0:0:0
0:0:0:0:4:7:8:10:8:7:6:0:0:0:0:0:0:0:0:0:0:0:0:0:0:0:0:0:0:0:0:0:0:0:0:0:0:0:0:0:0:0:0:0:0:0:0:0:0:0:0:0:0:6:8:10:10:11:8:6:0:0:0:0
0:0:0:0:4:7:8:10:8:7:6:0:0:0:0:0:0:0:0:0:0:0:0:0:0:0:0:0:0:0:0:0:0:0:0:0:0:0:0:0:0:0:0:0:0:0:0:0:0:0:0:0:0:6:8:10:10:11:8:6:0:0:0:0
0:0:0:0:4:7:8:10:8:7:6:0:0:0:0:0:0:0:0:0:0:0:0:0:0:0:0:0:0:0:0:0:0:0:0:0:0:0:0:0:0:0:0:0:0:0:0:0:0:0:0:0:0:6:8:10:10:11:8:6:0:0:0:0
0:0:0:0:4:7:8:10:8:7:6:0:0:0:0:0:0:0:0:0:0:0:0:0:0:0:0:0:0:0:0:0:0:0:0:0:0:5:6:3:0:0:0:0:0:0:0:0:0:0:0:0:0:6:8:10:10:11:8:6:0:0:0:0
0:0:0:0:4:7:8:10:8:7:6:0:0:0:0:0:0:0:0:0:0:0:0:0:0:0:0:0:0:0:0:0:0:0:0:0:0:5:7:8:4:0:0:0:0:0:0:0:0:0:0:0:0:6:8:10:10:11:8:6:0:0:0:0
0:0:0:0:4:7:8:10:8:7:6:0:0:0:0:0:0:0:0:0:0:0:0:0:0:0:0:0:0:0:0:0:0:0:0:0:0:4:8:10:6:5:0:0:0:0:0:0:0:0:0:0:0:6:8:10:10:11:8:6:0:0:0:0
0:0:0:0:4:7:8:10:8:7:6:0:0:0:0:0:0:0:0:0:0:0:0:0:0:0:0:0:0:0:0:0:0:0:0:0:0:3:7:12:8:4:0:0:0:0:0:0:0:0:0:0:0:6:8:10:10:11:8:6:0:0:0:0
0:0:0:0:4:7:8:10:8:7:6:0:0:0:0:0:0:0:0:0:0:0:0:0:0:0:0:0:0:0:0:0:0:0:0:0:0:1:6:9:8:5:0:0:0:0:0:0:0:0:0:0:0:6:8:10:10:11:8:6:0:0:0:0
0:0:0:0:4:7:8:10:8:7:6:0:0:0:0:0:0:0:0:0:0:0:0:0:0:0:0:0:0:0:0:0:0:0:0:0:0:0:2:6:4:0:0:0:0:0:0:0:0:0:0:0:0:6:8:10:10:11:8:6:0:0:0:0
0:0:0:0:4:7:8:10:8:7:6:0:0:0:0:0:0:0:0:0:0:0:0:0:0:0:0:0:0:0:0:0:0:0:0:0:0:0:0:3:0:0:0:0:0:0:0:0:0:0:0:0:0:6:8:10:10:11:8:6:0:0:0:0
0:0:0:0:4:7:8:10:8:7:6:0:0:0:0:0:0:0:0:0:0:0:0:0:0:0:0:0:0:0:0:0:0:0:0:0:0:0:0:0:0:0:0:0:0:0:0:0:0:0:0:0:0:6:8:10:10:11:8:6:0:0:0:0
0:0:0:0:4:7:8:10:8:7:6:0:0:0:0:0:0:0:0:0:0:0:0:0:0:0:0:0:0:0:0:0:0:0:0:0:0:0:0:0:0:0:0:0:0:0:0:0:0:0:0:0:0:6:8:10:10:11:8:6:0:0:0:0
0:0:0:0:4:7:8:10:8:7:6:0:0:0:0:0:0:0:0:0:0:0:0:0:0:0:0:0:0:0:0:0:0:0:0:0:0:0:0:0:0:0:0:0:0:0:0:0:0:0:0:0:0:6:8:10:10:11:8:6:0:0:0:0
0:0:0:0:4:7:8:10:8:7:6:0:0:0:0:0:0:0:0:0:0:0:0:0:0:0:0:0:0:0:0:0:0:0:0:0:0:0:0:0:0:0:0:0:0:0:0:0:0:0:0:0:0:6:8:10:10:11:8:6:0:0:0:0
0:0:0:0:4:7:8:10:8:7:6:0:0:0:0:0:0:0:0:0:0:0:0:0:0:0:0:0:0:0:0:0:0:0:0:0:0:0:0:0:0:0:0:0:0:0:0:0:0:0:0:0:0:6:8:10:10:11:8:6:0:0:0:0
0:0:0:0:4:7:8:10:8:7:6:0:0:0:0:0:0:0:0:0:0:0:0:0:0:0:0:0:0:0:0:0:0:0:0:0:0:0:0:0:0:0:0:0:0:0:0:0:0:0:0:0:0:6:8:10:10:11:8:6:0:0:0:0
0:0:0:0:4:7:8:10:8:7:6:0:0:0:0:0:0:0:0:0:0:0:0:0:0:0:0:0:0:0:0:0:0:0:0:0:0:0:0:0:0:0:0:0:0:0:0:0:0:0:0:0:0:6:8:10:10:11:8:6:0:0:0:0
0:0:0:0:4:7:8:10:8:7:6:0:0:0:0:0:0:0:0:0:0:0:0:0:0:0:0:0:0:0:0:0:0:0:0:0:0:0:0:0:0:0:0:0:0:0:0:0:0:0:0:0:0:6:8:10:10:11:8:6:0:0:0:0
0:0:0:0:4:7:8:10:8:7:6:0:0:0:0:0:0:0:0:0:0:0:0:0:0:0:0:0:0:0:0:0:0:0:0:0:0:0:0:0:0:0:0:0:0:0:0:0:0:0:0:0:0:6:8:10:10:11:8:6:0:0:0:0
0:0:0:0:4:7:8:10:8:7:6:0:0:0:0:0:0:0:0:0:0:0:0:0:0:0:0:0:0:0:0:0:0:0:0:0:0:0:0:0:0:0:0:0:0:0:0:0:0:0:0:0:0:6:8:10:10:11:8:6:0:0:0:0
0:0:0:0:4:7:8:10:8:7:6:0:0:0:0:0:0:0:0:0:0:0:0:0:0:0:0:0:0:0:0:0:0:0:0:0:0:0:0:0:0:0:0:0:0:0:0:0:0:0:0:0:0:6:8:10:10:11:8:6:0:0:0:0
0:0:0:0:4:7:8:10:8:7:6:0:0:0:0:0:0:0:0:0:0:0:0:0:0:0:0:0:0:0:0:0:0:0:0:0:0:0:0:0:0:0:0:0:0:0:0:0:0:0:0:0:0:6:8:10:10:11:8:6:0:0:0:0
0:0:0:0:4:7:8:10:8:7:6:0:0:0:0:0:0:0:0:0:0:0:0:0:0:0:0:0:0:0:0:0:0:0:0:0:0:0:0:0:0:0:0:0:0:0:0:0:0:0:0:0:0:6:8:10:10:11:8:6:0:0:0:0
0:0:0:0:4:7:8:10:8:7:6:0:0:0:0:0:0:0:0:0:0:0:0:0:0:0:0:0:0:0:0:0:0:0:0:0:0:0:0:0:0:0:0:0:0:0:0:0:0:0:0:0:0:6:8:10:10:11:8:6:0:0:0:0
0:0:0:0:4:7:8:10:8:7:6:0:0:0:0:0:0:0:0:0:0:0:0:0:0:0:0:0:0:0:0:0:0:0:0:0:0:0:0:0:0:0:0:0:0:0:0:0:0:0:0:0:0:6:8:10:10:11:8:6:0:0:0:0
0:0:0:0:4:7:8:10:8:7:6:0:0:0:0:0:0:0:0:0:0:0:0:0:0:0:0:0:0:0:0:0:0:0:0:0:0:0:0:0:0:0:0:0:0:0:0:0:0:0:0:0:0:6:8:10:10:11:8:6:0:0:0:0
0:0:0:0:4:7:8:10:8:7:6:0:0:0:0:0:0:0:0:0:0:0:0:0:0:0:0:0:0:0:0:0:0:0:0:0:0:0:0:0:0:0:0:0:0:0:0:0:0:0:0:0:0:6:8:10:10:11:8:6:0:0:0:0
0:0:0:0:4:7:8:10:8:7:6:0:0:0:0:0:0:0:0:0:0:0:0:0:0:0:0:0:0:0:0:0:0:0:0:0:0:0:0:0:0:0:0:0:0:0:0:0:0:0:0:0:0:6:8:10:10:11:8:6:0:0:0:0
0:0:0:0:4:7:8:10:8:7:6:0:0:0:0:0:0:0:0:0:0:0:0:0:0:0:0:0:0:0:0:0:0:0:0:0:0:0:0:0:0:0:0:0:0:0:0:0:0:0:0:0:0:6:8:10:10:11:8:6:0:0:0:0
0:0:0:0:4:7:8:10:8:7:6:0:0:0:0:0:0:0:0:0:0:0:0:0:0:0:0:0:0:0:0:0:0:0:0:0:0:0:0:0:0:0:0:0:0:0:0:0:0:0:0:0:0:6:8:10:10:11:8:6:0:0:0:0
0:0:0:0:4:7:8:10:8:7:6:0:0:0:0:0:0:0:0:0:0:0:0:0:0:0:0:0:0:0:0:0:0:0:0:0:0:0:0:0:0:0:0:0:0:0:0:0:0:0:0:0:0:6:8:10:10:11:8:6:0:0:0:0
0:0:0:0:4:7:8:10:8:7:6:0:0:0:0:0:0:0:0:0:0:0:0:0:0:0:0:0:0:0:0:0:0:0:0:0:0:0:0:0:0:0:0:0:0:0:0:0:0:0:0:0:0:6:8:10:10:11:8:6:0:0:0:0
0:0:0:0:4:7:8:10:8:7:6:0:0:0:0:0:0:0:0:0:0:0:0:0:0:0:0:0:0:0:0:0:0:0:0:0:0:0:0:0:0:0:0:0:0:0:0:0:0:0:0:0:0:6:8:10:10:11:8:6:0:0:0:0
0:0:0:0:4:7:8:10:8:7:6:0:0:0:0:0:0:0:0:0:0:0:0:0:0:0:0:0:0:0:0:0:0:0:0:0:0:0:0:0:0:0:0:0:0:0:0:0:0:0:0:0:0:6:8:10:10:11:8:6:0:0:0:0
0:0:0:0:4:7:8:10:8:7:6:0:0:0:0:0:0:0:0:0:0:0:0:0:0:0:0:0:0:0:0:0:0:0:0:0:0:0:0:0:0:0:0:0:0:0:0:0:0:0:0:0:0:6:8:10:10:11:8:6:0:0:0:0
0:0:0:0:4:7:8:10:8:7:6:0:0:0:0:0:0:0:0:0:0:0:0:0:0:0:0:0:0:0:0:0:0:0:0:0:0:0:0:0:0:0:0:0:0:0:0:0:0:0:0:0:0:6:8:10:10:11:8:6:0:0:0:0
0:0:0:0:4:7:8:10:8:7:6:0:0:0:0:0:0:0:0:0:0:0:0:0:0:0:0:0:0:0:0:0:0:0:0:0:0:0:0:0:0:0:0:0:0:0:0:0:0:0:0:0:0:6:8:10:10:11:8:6:0:0:0:0
0:0:1:4:6:10:11:10:10:11:10:10:11:10:10:11:10:10:11:10:10:11:10:10:11:10:10:11:10:11:10:10:11:10:10:11:10:10:11:10:10:11:10:10:11:10:10:11:10:10:11:10:10:11:10:10:11:10:8:2:0:0:0:0
0:0:1:4:6:10:11:10:10:11:10:10:11:10:10:11:10:10:11:10:10:11:10:10:11:10:10:11:10:11:10:10:11:10:10:11:10:10:11:10:10:11:10:10:11:10:10:11:10:10:11:10:10:11:10:10:11:10:8:2:0:0:0:0
0:0:1:4:6:10:11:10:10:11:10:10:11:10:10:11:10:10:11:10:10:11:10:10:11:10:10:11:10:11:10:10:11:10:10:11:10:10:11:10:10:11:10:10:11:10:10:11:10:10:11:10:10:11:10:10:11:10:8:2:0:0:0:0
0:0:0:0:0:0:0:0:0:0:0:0:0:0:0:0:0:0:0:0:0:0:0:0:0:0:0:0:0:0:0:0:0:0:0:0:0:0:0:0:0:0:0:0:0:0:0:0:0:0:0:0:0:0:0:0:0:0:0:0:0:0:0:0
0:0:0:0:0:0:0:0:0:0:0:0:0:0:0:0:0:0:0:0:0:0:0:0:0:0:0:0:0:0:0:0:0:0:0:0:0:0:0:0:0:0:0:0:0:0:0:0:0:0:0:0:0:0:0:0:0:0:0:0:0:0:0:0
0:0:0:0:0:0:0:0:0:0:0:0:0:0:0:0:0:0:0:0:0:0:0:0:0:0:0:0:0:0:0:0:0:0:0:0:0:0:0:0:0:0:0:0:0:0:0:0:0:0:0:0:0:0:0:0:0:0:0:0:0:0:0:0
0:0:0:0:0:0:0:0:0:0:0:0:0:0:0:0:0:0:0:0:0:0:0:0:0:0:0:0:0:0:0:0:0:0:0:0:0:0:0:0:0:0:0:0:0:0:0:0:0:0:0:0:0:0:0:0:0:0:0:0:0:0:0:0
0:0:0:0:0:0:0:0:0:0:0:0:0:0:0:0:0:0:0:0:0:0:0:0:0:0:0:0:0:0:0:0:0:0:0:0:0:0:0:0:0:0:0:0:0:0:0:0:0:0:0:0:0:0:0:0:0:0:0:0:0:0:0:0
